###################
#                 #
#                 #
#      12222222222#
#                 #
#                 #
#                 #
#                 #
#                 #
#                 #
#                 #
#                 #
#                 #
###################