11111111111111111111111111111111111111111111111111
14441004400404004230004400001442224223422224341141
14544004400400404230004422301411422223112424334221
14441004100404004230004400301221441143334432233421
11114111111111111111111110001243444224433144133141
14444444444444441434242424441223344222222113233431
14444444444444441243434244441344233414422334233441
14444444444444441424242424441433233442144342244441
14444444444444441343111111111444223312443322444141
14444444444444441000000000000134123324433422434411
14444444444444441020002020200134131224334214131411
14444444444444441000000000000124333224344414433311
14444444444444441020002000200134434441344412331441
14444444444444441000000000000122331143311222114441
14444444444444441020202000200142334443312233114411
14444444444444441000000000000141322433444233114111
14444444444444441000000000200143322411341433144111
14444444444444441111111110001142321442222423144441
14444444444444444444444412444312322442222423144441
14444444444444444444444412242222131244221433144441
14444444444444444444444412243213332222144433144441
14444444444444444444444411111111111111111111114441
14444444444444444444444444444444444444444444444441
14444444444444444444444444444444444444444444444441
14444444444444444444444444444444444444444444444441
14444444411111111444444444444444444444444444444441
14444444144444444144444444444444444444444444444441
14444441444444444414441114443334442224444444444441
14444441444444444414441414443434442424444444444441
14444441444444444414441114443334442224444444444441
14444441444444444414444444444444444444444444444441
14444441444444444414444444444444444444444444444441
14444441444433332214444444444444444444444444444441
14444441444434434000444444444444444444444444444441
14444441442432432000444444444444444444444444444441
14444441444434434000444444444444444444444444444441
14444441442432432000444444444444444444444444444441
14444441444434434000444444444444444444444444444441
14444441444433332214444444444444444444444444444441
14444441444444444414444444444444444444444444444441
14444441444444444414444444444444444444444444444441
14444441444444444414441114443334442224444444444441
14444441444444444414441414443434442424444444444441
14444441444444444414441114443334442224444444444441
14444444144444444144444444444444444444444444444441
14444444411111111444444444444444444444444444444441
14444444444444444444444444444444444444444444444441
14444444444444444444444444444444444444444444444441
14444444444444444444444444444444444444444444444441
11111111111111111111111111111111111111111111111111
